ASSIGNMENT 0 : RLI_08_00 

GROUP 0 : SILVIA SIJIA LÓPEZ ROLDÁN, VAKO KHVEDELIDZE, KENNY TOHME
GROUP 1 : DANIEL AGUILAR POLANCO, ADRIAN KIA REKAA HÅSINI DA SILVA, MICHAIL SIFAKIS
GROUP 2 : JOUD SULEIMAN MOHAMMED TAHER, ENRIQUE RIVELA GÓMEZ, MIA DRAGOVIC
GROUP 3 : ELIAS NMEIR MRAD, MATTEO COLANTONI, SAEKA ONO
GROUP 4 : SOFIA BOICENCO, DENIS SOKOLOV  IVANOV, BEATRIZ MARTÍN MARTÍN
GROUP 5 : OMAR EL HAJJ CHEHADE, GEORGE VASHAKIDZE, BLANCA VALDÉS CAPARROS
GROUP 6 : OLIVER JACKSON HOLMES, OSKAR SZYMON KLOCZKO, SIMONIDA JEKIC
GROUP 7 : FAIROUZ ABOU MOUSA, ADRIANA FERNANDA CASTAÑON MOORE, NATHANIEL NADER AYOUB
GROUP 8 : SAMI MOHAB AKHNOUKH, FELIX LOVE FREDRIK WESTIN, SALMANE MOUHIB
GROUP 9 : GIOVANNI NOCERINO, WILLIAM YAMMINE, LEENA YOUSEF KAMEL EL-BARQ
GROUP 10 : JAIME PAZ VELASCO, MARIA JOSE COLMENAREZ ORTIZ, GONZALO NICOLÁS FERNÁNDEZ DE CÓRDOBA JAVRONICH
GROUP 11 : RYAN KURT MÜNKER, RONALD SEBASTIÁN BELTRÁN NÚÑEZ, NIKOLAS ANTON LAFRENTZ
GROUP 12 : MATTHEW MAINGOT GERSTEIN, QAMAR HARITH HUSSEIN AFTAN, RUBÉN DE JUAN GRANDE
GROUP 13 : SOFIIA AVETISIAN, JACK RAJA SHAWKI SAMAWI, MANUEL MERINO ZORRILLA
GROUP 14 : SOFIA CLAUDIA BONOAN  SAN JOSÉ, MAXIMILIANO MARTÍN MALUJE, MONA ASHRUF AHMED ALMADI

FAIROUZ ABOU MOUSA : GROUP 7 WITH ADRIANA FERNANDA CASTAÑON MOORE, NATHANIEL NADER AYOUB
QAMAR HARITH HUSSEIN AFTAN : GROUP 12 WITH MATTHEW MAINGOT GERSTEIN, RUBÉN DE JUAN GRANDE
DANIEL AGUILAR POLANCO : GROUP 1 WITH ADRIAN KIA REKAA HÅSINI DA SILVA, MICHAIL SIFAKIS
SAMI MOHAB AKHNOUKH : GROUP 8 WITH FELIX LOVE FREDRIK WESTIN, SALMANE MOUHIB
MONA ASHRUF AHMED ALMADI : GROUP 14 WITH SOFIA CLAUDIA BONOAN  SAN JOSÉ, MAXIMILIANO MARTÍN MALUJE
SOFIIA AVETISIAN : GROUP 13 WITH JACK RAJA SHAWKI SAMAWI, MANUEL MERINO ZORRILLA
NATHANIEL NADER AYOUB : GROUP 7 WITH FAIROUZ ABOU MOUSA, ADRIANA FERNANDA CASTAÑON MOORE
RONALD SEBASTIÁN BELTRÁN NÚÑEZ : GROUP 11 WITH RYAN KURT MÜNKER, NIKOLAS ANTON LAFRENTZ
SOFIA BOICENCO : GROUP 4 WITH DENIS SOKOLOV  IVANOV, BEATRIZ MARTÍN MARTÍN
SOFIA CLAUDIA BONOAN  SAN JOSÉ : GROUP 14 WITH MAXIMILIANO MARTÍN MALUJE, MONA ASHRUF AHMED ALMADI
ADRIANA FERNANDA CASTAÑON MOORE : GROUP 7 WITH FAIROUZ ABOU MOUSA, NATHANIEL NADER AYOUB
MATTEO COLANTONI : GROUP 3 WITH ELIAS NMEIR MRAD, SAEKA ONO
MARIA JOSE COLMENAREZ ORTIZ : GROUP 10 WITH JAIME PAZ VELASCO, GONZALO NICOLÁS FERNÁNDEZ DE CÓRDOBA JAVRONICH
ADRIAN KIA REKAA HÅSINI DA SILVA : GROUP 1 WITH DANIEL AGUILAR POLANCO, MICHAIL SIFAKIS
RUBÉN DE JUAN GRANDE : GROUP 12 WITH MATTHEW MAINGOT GERSTEIN, QAMAR HARITH HUSSEIN AFTAN
MIA DRAGOVIC : GROUP 2 WITH JOUD SULEIMAN MOHAMMED TAHER, ENRIQUE RIVELA GÓMEZ
LEENA YOUSEF KAMEL EL-BARQ : GROUP 9 WITH GIOVANNI NOCERINO, WILLIAM YAMMINE
OMAR EL HAJJ CHEHADE : GROUP 5 WITH GEORGE VASHAKIDZE, BLANCA VALDÉS CAPARROS
GONZALO NICOLÁS FERNÁNDEZ DE CÓRDOBA JAVRONICH : GROUP 10 WITH JAIME PAZ VELASCO, MARIA JOSE COLMENAREZ ORTIZ
OLIVER JACKSON HOLMES : GROUP 6 WITH OSKAR SZYMON KLOCZKO, SIMONIDA JEKIC
SIMONIDA JEKIC : GROUP 6 WITH OLIVER JACKSON HOLMES, OSKAR SZYMON KLOCZKO
VAKO KHVEDELIDZE : GROUP 0 WITH SILVIA SIJIA LÓPEZ ROLDÁN, KENNY TOHME
OSKAR SZYMON KLOCZKO : GROUP 6 WITH OLIVER JACKSON HOLMES, SIMONIDA JEKIC
NIKOLAS ANTON LAFRENTZ : GROUP 11 WITH RYAN KURT MÜNKER, RONALD SEBASTIÁN BELTRÁN NÚÑEZ
SILVIA SIJIA LÓPEZ ROLDÁN : GROUP 0 WITH VAKO KHVEDELIDZE, KENNY TOHME
MATTHEW MAINGOT GERSTEIN : GROUP 12 WITH QAMAR HARITH HUSSEIN AFTAN, RUBÉN DE JUAN GRANDE
MAXIMILIANO MARTÍN MALUJE : GROUP 14 WITH SOFIA CLAUDIA BONOAN  SAN JOSÉ, MONA ASHRUF AHMED ALMADI
BEATRIZ MARTÍN MARTÍN : GROUP 4 WITH SOFIA BOICENCO, DENIS SOKOLOV  IVANOV
MANUEL MERINO ZORRILLA : GROUP 13 WITH SOFIIA AVETISIAN, JACK RAJA SHAWKI SAMAWI
SALMANE MOUHIB : GROUP 8 WITH SAMI MOHAB AKHNOUKH, FELIX LOVE FREDRIK WESTIN
RYAN KURT MÜNKER : GROUP 11 WITH RONALD SEBASTIÁN BELTRÁN NÚÑEZ, NIKOLAS ANTON LAFRENTZ
ELIAS NMEIR MRAD : GROUP 3 WITH MATTEO COLANTONI, SAEKA ONO
GIOVANNI NOCERINO : GROUP 9 WITH WILLIAM YAMMINE, LEENA YOUSEF KAMEL EL-BARQ
SAEKA ONO : GROUP 3 WITH ELIAS NMEIR MRAD, MATTEO COLANTONI
JAIME PAZ VELASCO : GROUP 10 WITH MARIA JOSE COLMENAREZ ORTIZ, GONZALO NICOLÁS FERNÁNDEZ DE CÓRDOBA JAVRONICH
ENRIQUE RIVELA GÓMEZ : GROUP 2 WITH JOUD SULEIMAN MOHAMMED TAHER, MIA DRAGOVIC
JACK RAJA SHAWKI SAMAWI : GROUP 13 WITH SOFIIA AVETISIAN, MANUEL MERINO ZORRILLA
MICHAIL SIFAKIS : GROUP 1 WITH DANIEL AGUILAR POLANCO, ADRIAN KIA REKAA HÅSINI DA SILVA
DENIS SOKOLOV  IVANOV : GROUP 4 WITH SOFIA BOICENCO, BEATRIZ MARTÍN MARTÍN
JOUD SULEIMAN MOHAMMED TAHER : GROUP 2 WITH ENRIQUE RIVELA GÓMEZ, MIA DRAGOVIC
KENNY TOHME : GROUP 0 WITH SILVIA SIJIA LÓPEZ ROLDÁN, VAKO KHVEDELIDZE
BLANCA VALDÉS CAPARROS : GROUP 5 WITH OMAR EL HAJJ CHEHADE, GEORGE VASHAKIDZE
GEORGE VASHAKIDZE : GROUP 5 WITH OMAR EL HAJJ CHEHADE, BLANCA VALDÉS CAPARROS
FELIX LOVE FREDRIK WESTIN : GROUP 8 WITH SAMI MOHAB AKHNOUKH, SALMANE MOUHIB
WILLIAM YAMMINE : GROUP 9 WITH GIOVANNI NOCERINO, LEENA YOUSEF KAMEL EL-BARQ
