ASSIGNMENT 0 : RLI_08_00 

GROUP 0 : KAREEM RAMI JAMIL HAWWASH, HALA AMR YAGHI, HUGO KOTÚC
GROUP 1 : FEDERICA IOLA CASELLI, JUAN SEBASTIAN PEÑA DONNEYS, SOFIA GONZALEZ LOZANO
GROUP 2 : LUIS ANDRÉS INFANTE NÚÑEZ, DIEGO OLIVEROS RABAGO, GEETHIKA REDDY KONDA
GROUP 3 : GEORGIOS KLONIS, VLAD SOIMU, BORIS ISAH HENDRIK GANS
GROUP 4 : NIKOLOZ KIPIANI, HIBBA YASEEN TAHA ALKAMAS, LUCAS KARL VAN ZYL
GROUP 5 : DAVID ALAN HOERZ, ANDREA ISABEL MONTAÑA LAMUS, CAYETANA HINOSTROZA TAMAYO
GROUP 6 : ALP ARSLAN BAGHIROV, SAAD AYOMIDE OLOWOLAYEMO, ILINCA CORBU
GROUP 7 : DAVID VELASCO HERRUZO, CATERINA MARÍA BARBERO ROS, ARIEL ERNESTO MOREIRA GUERRERO
GROUP 8 : JAD CHEBLY, OMAR MEKKAWI YASSIN, NICOLÁS LEYVA GONZÁLEZ
GROUP 9 : AN?E ZGONC, MATTHEW WARREN PORTEOUS, JAVIER DOMÍNGUEZ SEGURA
GROUP 10 : THOMAS RAMSEY SALEM, <NOBODY>, GABRIELA VEGA VICTORIA
GROUP 11 : FARES RAFIQ SHAWKAT AL QADOUMI, JOSÉ MARÍA LARIOS MADRID, BORJA VALENTIN ALBERS-SCHÖENBERG ENGELER
GROUP 12 : SABINA-CATINCA BACAOANU, GREGORIO SANTI FURNARI, FAISAL KANJ (MOH'D NOUR) JUNBLATT
GROUP 13 : ALEJANDRO HELMRICH LAURA, YOUSEF AMIRGHOFRAN, JULIETTE JANNE DOTHEE
GROUP 14 : <NOBODY>, JUAN ALONSO-ALLENDE ZABALA, IRINA IZQUIERDO IGLESIAS
GROUP 15 : LÉA ABOU JAOUDÉ, OMAR HAYTHAM ATTA ISSA, DIANA CAROLINA CORDOVEZ YOUNG

LÉA ABOU JAOUDÉ : GROUP 15 WITH OMAR HAYTHAM ATTA ISSA, DIANA CAROLINA CORDOVEZ YOUNG
BORJA VALENTIN ALBERS-SCHÖENBERG ENGELER : GROUP 11 WITH FARES RAFIQ SHAWKAT AL QADOUMI, JOSÉ MARÍA LARIOS MADRID
HIBBA YASEEN TAHA ALKAMAS : GROUP 4 WITH NIKOLOZ KIPIANI, LUCAS KARL VAN ZYL
JUAN ALONSO-ALLENDE ZABALA : GROUP 14 WITH <NOBODY>, IRINA IZQUIERDO IGLESIAS
FARES RAFIQ SHAWKAT AL QADOUMI : GROUP 11 WITH JOSÉ MARÍA LARIOS MADRID, BORJA VALENTIN ALBERS-SCHÖENBERG ENGELER
YOUSEF AMIRGHOFRAN : GROUP 13 WITH ALEJANDRO HELMRICH LAURA, JULIETTE JANNE DOTHEE
SABINA-CATINCA BACAOANU : GROUP 12 WITH GREGORIO SANTI FURNARI, FAISAL KANJ (MOH'D NOUR) JUNBLATT
ALP ARSLAN BAGHIROV : GROUP 6 WITH SAAD AYOMIDE OLOWOLAYEMO, ILINCA CORBU
CATERINA MARÍA BARBERO ROS : GROUP 7 WITH DAVID VELASCO HERRUZO, ARIEL ERNESTO MOREIRA GUERRERO
FEDERICA IOLA CASELLI : GROUP 1 WITH JUAN SEBASTIAN PEÑA DONNEYS, SOFIA GONZALEZ LOZANO
JAD CHEBLY : GROUP 8 WITH OMAR MEKKAWI YASSIN, NICOLÁS LEYVA GONZÁLEZ
ILINCA CORBU : GROUP 6 WITH ALP ARSLAN BAGHIROV, SAAD AYOMIDE OLOWOLAYEMO
DIANA CAROLINA CORDOVEZ YOUNG : GROUP 15 WITH LÉA ABOU JAOUDÉ, OMAR HAYTHAM ATTA ISSA
JAVIER DOMÍNGUEZ SEGURA : GROUP 9 WITH AN?E ZGONC, MATTHEW WARREN PORTEOUS
GREGORIO SANTI FURNARI : GROUP 12 WITH SABINA-CATINCA BACAOANU, FAISAL KANJ (MOH'D NOUR) JUNBLATT
BORIS ISAH HENDRIK GANS : GROUP 3 WITH GEORGIOS KLONIS, VLAD SOIMU
SOFIA GONZALEZ LOZANO : GROUP 1 WITH FEDERICA IOLA CASELLI, JUAN SEBASTIAN PEÑA DONNEYS
KAREEM RAMI JAMIL HAWWASH : GROUP 0 WITH HALA AMR YAGHI, HUGO KOTÚC
ALEJANDRO HELMRICH LAURA : GROUP 13 WITH YOUSEF AMIRGHOFRAN, JULIETTE JANNE DOTHEE
CAYETANA HINOSTROZA TAMAYO : GROUP 5 WITH DAVID ALAN HOERZ, ANDREA ISABEL MONTAÑA LAMUS
DAVID ALAN HOERZ : GROUP 5 WITH ANDREA ISABEL MONTAÑA LAMUS, CAYETANA HINOSTROZA TAMAYO
LUIS ANDRÉS INFANTE NÚÑEZ : GROUP 2 WITH DIEGO OLIVEROS RABAGO, GEETHIKA REDDY KONDA
OMAR HAYTHAM ATTA ISSA : GROUP 15 WITH LÉA ABOU JAOUDÉ, DIANA CAROLINA CORDOVEZ YOUNG
IRINA IZQUIERDO IGLESIAS : GROUP 14 WITH <NOBODY>, JUAN ALONSO-ALLENDE ZABALA
JULIETTE JANNE DOTHEE : GROUP 13 WITH ALEJANDRO HELMRICH LAURA, YOUSEF AMIRGHOFRAN
FAISAL KANJ (MOH'D NOUR) JUNBLATT : GROUP 12 WITH SABINA-CATINCA BACAOANU, GREGORIO SANTI FURNARI
NIKOLOZ KIPIANI : GROUP 4 WITH HIBBA YASEEN TAHA ALKAMAS, LUCAS KARL VAN ZYL
GEORGIOS KLONIS : GROUP 3 WITH VLAD SOIMU, BORIS ISAH HENDRIK GANS
GEETHIKA REDDY KONDA : GROUP 2 WITH LUIS ANDRÉS INFANTE NÚÑEZ, DIEGO OLIVEROS RABAGO
HUGO KOTÚC : GROUP 0 WITH KAREEM RAMI JAMIL HAWWASH, HALA AMR YAGHI
JOSÉ MARÍA LARIOS MADRID : GROUP 11 WITH FARES RAFIQ SHAWKAT AL QADOUMI, BORJA VALENTIN ALBERS-SCHÖENBERG ENGELER
NICOLÁS LEYVA GONZÁLEZ : GROUP 8 WITH JAD CHEBLY, OMAR MEKKAWI YASSIN
OMAR MEKKAWI YASSIN : GROUP 8 WITH JAD CHEBLY, NICOLÁS LEYVA GONZÁLEZ
ANDREA ISABEL MONTAÑA LAMUS : GROUP 5 WITH DAVID ALAN HOERZ, CAYETANA HINOSTROZA TAMAYO
ARIEL ERNESTO MOREIRA GUERRERO : GROUP 7 WITH DAVID VELASCO HERRUZO, CATERINA MARÍA BARBERO ROS
DIEGO OLIVEROS RABAGO : GROUP 2 WITH LUIS ANDRÉS INFANTE NÚÑEZ, GEETHIKA REDDY KONDA
SAAD AYOMIDE OLOWOLAYEMO : GROUP 6 WITH ALP ARSLAN BAGHIROV, ILINCA CORBU
JUAN SEBASTIAN PEÑA DONNEYS : GROUP 1 WITH FEDERICA IOLA CASELLI, SOFIA GONZALEZ LOZANO
MATTHEW WARREN PORTEOUS : GROUP 9 WITH AN?E ZGONC, JAVIER DOMÍNGUEZ SEGURA
THOMAS RAMSEY SALEM : GROUP 10 WITH <NOBODY>, GABRIELA VEGA VICTORIA
VLAD SOIMU : GROUP 3 WITH GEORGIOS KLONIS, BORIS ISAH HENDRIK GANS
LUCAS KARL VAN ZYL : GROUP 4 WITH NIKOLOZ KIPIANI, HIBBA YASEEN TAHA ALKAMAS
GABRIELA VEGA VICTORIA : GROUP 10 WITH THOMAS RAMSEY SALEM, <NOBODY>
DAVID VELASCO HERRUZO : GROUP 7 WITH CATERINA MARÍA BARBERO ROS, ARIEL ERNESTO MOREIRA GUERRERO
HALA AMR YAGHI : GROUP 0 WITH KAREEM RAMI JAMIL HAWWASH, HUGO KOTÚC
AN?E ZGONC : GROUP 9 WITH MATTHEW WARREN PORTEOUS, JAVIER DOMÍNGUEZ SEGURA
<NOBODY> : GROUP 14 WITH JUAN ALONSO-ALLENDE ZABALA, IRINA IZQUIERDO IGLESIAS
<NOBODY> : GROUP 10 WITH THOMAS RAMSEY SALEM, GABRIELA VEGA VICTORIA
